"filename", "language", "TypeScript", "JavaScript", "PHP", "HTML", "CSS", "comment", "blank", "total"
"/Users/riadmammadov/Documents/Individual Project/Code/src/app.ts", "TypeScript", 42, 0, 0, 0, 0, 0, 18, 60
"/Users/riadmammadov/Documents/Individual Project/Code/src/controllers/auth.controller.ts", "TypeScript", 163, 0, 0, 0, 0, 6, 33, 202
"/Users/riadmammadov/Documents/Individual Project/Code/src/controllers/home.controller.ts", "TypeScript", 16, 0, 0, 0, 0, 5, 9, 30
"/Users/riadmammadov/Documents/Individual Project/Code/src/controllers/protected.controller.ts", "TypeScript", 20, 0, 0, 0, 0, 5, 11, 36
"/Users/riadmammadov/Documents/Individual Project/Code/src/middleware/auth.middleware.ts", "TypeScript", 62, 0, 0, 0, 0, 5, 13, 80
"/Users/riadmammadov/Documents/Individual Project/Code/src/public/backend/additem.php", "PHP", 0, 0, 44, 0, 0, 9, 17, 70
"/Users/riadmammadov/Documents/Individual Project/Code/src/public/backend/applyDiscount.php", "PHP", 0, 0, 41, 0, 0, 4, 9, 54
"/Users/riadmammadov/Documents/Individual Project/Code/src/public/backend/cancelorder.php", "PHP", 0, 0, 22, 0, 0, 3, 8, 33
"/Users/riadmammadov/Documents/Individual Project/Code/src/public/backend/completeorder.php", "PHP", 0, 0, 29, 0, 0, 4, 10, 43
"/Users/riadmammadov/Documents/Individual Project/Code/src/public/backend/dbconnection.php", "PHP", 0, 0, 10, 0, 0, 1, 6, 17
"/Users/riadmammadov/Documents/Individual Project/Code/src/public/backend/deleteDiscount.php", "PHP", 0, 0, 21, 0, 0, 0, 7, 28
"/Users/riadmammadov/Documents/Individual Project/Code/src/public/backend/deleteOrderHistory.php", "PHP", 0, 0, 28, 0, 0, 5, 9, 42
"/Users/riadmammadov/Documents/Individual Project/Code/src/public/backend/deleteReview.php", "PHP", 0, 0, 15, 0, 0, 3, 5, 23
"/Users/riadmammadov/Documents/Individual Project/Code/src/public/backend/editItem.php", "PHP", 0, 0, 21, 0, 0, 2, 10, 33
"/Users/riadmammadov/Documents/Individual Project/Code/src/public/backend/getOrders.php", "PHP", 0, 0, 48, 0, 0, 2, 11, 61
"/Users/riadmammadov/Documents/Individual Project/Code/src/public/backend/getReviews.php", "PHP", 0, 0, 13, 0, 0, 0, 4, 17
"/Users/riadmammadov/Documents/Individual Project/Code/src/public/backend/getReviewsStaff.php", "PHP", 0, 0, 20, 0, 0, 1, 7, 28
"/Users/riadmammadov/Documents/Individual Project/Code/src/public/backend/getUserDetails.php", "PHP", 0, 0, 13, 0, 0, 0, 7, 20
"/Users/riadmammadov/Documents/Individual Project/Code/src/public/backend/getdata.php", "PHP", 0, 0, 14, 0, 0, 0, 6, 20
"/Users/riadmammadov/Documents/Individual Project/Code/src/public/backend/getproducts.php", "PHP", 0, 0, 18, 0, 0, 3, 9, 30
"/Users/riadmammadov/Documents/Individual Project/Code/src/public/backend/item.php", "PHP", 0, 0, 17, 0, 0, 3, 4, 24
"/Users/riadmammadov/Documents/Individual Project/Code/src/public/backend/listDiscounts.php", "PHP", 0, 0, 14, 0, 0, 0, 5, 19
"/Users/riadmammadov/Documents/Individual Project/Code/src/public/backend/maindata.php", "PHP", 0, 0, 49, 0, 0, 3, 6, 58
"/Users/riadmammadov/Documents/Individual Project/Code/src/public/backend/myserver.php", "PHP", 0, 0, 84, 0, 0, 8, 28, 120
"/Users/riadmammadov/Documents/Individual Project/Code/src/public/backend/orderhistorydata.php", "PHP", 0, 0, 40, 0, 0, 2, 9, 51
"/Users/riadmammadov/Documents/Individual Project/Code/src/public/backend/removeItem.php", "PHP", 0, 0, 28, 0, 0, 3, 10, 41
"/Users/riadmammadov/Documents/Individual Project/Code/src/public/backend/setDiscount.php", "PHP", 0, 0, 21, 0, 0, 0, 8, 29
"/Users/riadmammadov/Documents/Individual Project/Code/src/public/backend/submitReviews.php", "PHP", 0, 0, 22, 0, 0, 0, 7, 29
"/Users/riadmammadov/Documents/Individual Project/Code/src/public/backend/viewdetailmodal.php", "PHP", 0, 0, 63, 0, 0, 6, 9, 78
"/Users/riadmammadov/Documents/Individual Project/Code/src/public/cart.js", "JavaScript", 0, 390, 0, 0, 0, 37, 92, 519
"/Users/riadmammadov/Documents/Individual Project/Code/src/public/css/dashboard.css", "CSS", 0, 0, 0, 0, 349, 7, 115, 471
"/Users/riadmammadov/Documents/Individual Project/Code/src/public/css/forgotpass.css", "CSS", 0, 0, 0, 0, 73, 0, 9, 82
"/Users/riadmammadov/Documents/Individual Project/Code/src/public/css/index.css", "CSS", 0, 0, 0, 0, 321, 4, 122, 447
"/Users/riadmammadov/Documents/Individual Project/Code/src/public/css/orderpage.css", "CSS", 0, 0, 0, 0, 700, 11, 278, 989
"/Users/riadmammadov/Documents/Individual Project/Code/src/public/css/signin.css", "CSS", 0, 0, 0, 0, 91, 9, 21, 121
"/Users/riadmammadov/Documents/Individual Project/Code/src/public/css/signup.css", "CSS", 0, 0, 0, 0, 108, 10, 19, 137
"/Users/riadmammadov/Documents/Individual Project/Code/src/public/css/success.css", "CSS", 0, 0, 0, 0, 208, 0, 61, 269
"/Users/riadmammadov/Documents/Individual Project/Code/src/public/css/verification.css", "CSS", 0, 0, 0, 0, 64, 8, 10, 82
"/Users/riadmammadov/Documents/Individual Project/Code/src/public/dashboard.js", "JavaScript", 0, 771, 0, 0, 0, 75, 206, 1052
"/Users/riadmammadov/Documents/Individual Project/Code/src/public/html/cart.html", "HTML", 0, 0, 0, 83, 0, 10, 24, 117
"/Users/riadmammadov/Documents/Individual Project/Code/src/public/html/forgot-password.html", "HTML", 0, 0, 0, 105, 0, 0, 12, 117
"/Users/riadmammadov/Documents/Individual Project/Code/src/public/html/login.html", "HTML", 0, 0, 0, 37, 0, 9, 10, 56
"/Users/riadmammadov/Documents/Individual Project/Code/src/public/html/order_history.html", "HTML", 0, 0, 0, 29, 0, 1, 6, 36
"/Users/riadmammadov/Documents/Individual Project/Code/src/public/html/signup.html", "HTML", 0, 0, 0, 42, 0, 9, 7, 58
"/Users/riadmammadov/Documents/Individual Project/Code/src/public/html/staffdashboard.html", "HTML", 0, 0, 0, 432, 0, 26, 40, 498
"/Users/riadmammadov/Documents/Individual Project/Code/src/public/html/stafflogin.html", "HTML", 0, 0, 0, 23, 0, 10, 9, 42
"/Users/riadmammadov/Documents/Individual Project/Code/src/public/html/success.php", "PHP", 0, 0, 93, 0, 0, 3, 18, 114
"/Users/riadmammadov/Documents/Individual Project/Code/src/public/html/verification.html", "HTML", 0, 0, 0, 18, 0, 9, 6, 33
"/Users/riadmammadov/Documents/Individual Project/Code/src/public/index.html", "HTML", 0, 0, 0, 60, 0, 0, 15, 75
"/Users/riadmammadov/Documents/Individual Project/Code/src/public/index.js", "JavaScript", 0, 74, 0, 0, 0, 9, 22, 105
"/Users/riadmammadov/Documents/Individual Project/Code/src/public/orderhistory.js", "JavaScript", 0, 82, 0, 0, 0, 5, 18, 105
"/Users/riadmammadov/Documents/Individual Project/Code/src/public/signin.js", "JavaScript", 0, 55, 0, 0, 0, 3, 11, 69
"/Users/riadmammadov/Documents/Individual Project/Code/src/public/signup.js", "JavaScript", 0, 41, 0, 0, 0, 5, 5, 51
"/Users/riadmammadov/Documents/Individual Project/Code/src/public/staffsignin.js", "JavaScript", 0, 56, 0, 0, 0, 3, 12, 71
"/Users/riadmammadov/Documents/Individual Project/Code/src/public/success.js", "JavaScript", 0, 97, 0, 0, 0, 6, 21, 124
"/Users/riadmammadov/Documents/Individual Project/Code/src/public/verify.js", "JavaScript", 0, 32, 0, 0, 0, 4, 5, 41
"/Users/riadmammadov/Documents/Individual Project/Code/src/server.ts", "TypeScript", 21, 0, 0, 0, 0, 0, 8, 29
"/Users/riadmammadov/Documents/Individual Project/Code/src/services/cognito.service.ts", "TypeScript", 121, 0, 0, 0, 0, 5, 22, 148
"/Users/riadmammadov/Documents/Individual Project/Code/src/types/express/index.d.ts", "TypeScript", 8, 0, 0, 0, 0, 0, 1, 9
"Total", "-", 453, 1598, 788, 829, 1914, 361, 1500, 7443